001S1000000000000000000000000000
001P1000000000000000000000000000
001P1000000000000000000000000000
001P1000000000000000000000000000
001P1111111111111111111111111100
001PPPPPPPPPPPPPPPPPPPPPPPPPP100
0011111111111111111111111111P100
0000000000000000000000000001P100
0000000000000000000000000001P100
0000000000000000000000000001P100
0000000000000000000000000001P100
0000000000000000000000000001P100
0000000000000000000000000001P100
0000000000000000000000000001P100
0000000000000000000000000001P100
0000000000000000000000000001P100
1111111111111111111111111111P100
EPPPPPPPPPPPPPPPPPPPPPPPPPPPP100
11111111111111111111111111111100
00000000000000000000000000000000
00000000000000000000000000000000
00000000000000000000000000000000
00000000000000000000000000000000
00000000000000000000000000000000
00000000000000000000000000000000
00000000000000000000000000000000
00000000000000000000000000000000
00000000000000000000000000000000
00000000000000000000000000000000
00000000000000000000000000000000
00000000000000000000000000000000
00000000000000000000000000000000
